00000000000000000000000000000000000000000000000000
0-------------0----------------------------------0
0-------------0----------------------------------0
0-------------0---------------------0-----0000---0
000000------------------------0000000000-----0---0
0----------0000000------------------0--------0---0
0----------0------------------------00000--------0
0-----000000-------------?----------0---0-----0000
0----------0----------------------------0--------0
0----------0----------------------------0000-----0
0------------------------------------------0-----0
0----------------000000--------000000------0-----0
0------00000000-------000------0-----------0-H-H-0
0---0000------0-------0------000-----------0-----0
0------0-H--H-0-------0--------0----00000000000000
0---0--0------0-----------------------0----0000000
0-------------0-----------------------0----0000000
0-------------0----------------------------0000000
000000000000000000000000####0000000000000000000000
000000000000000000000----------0000000000000000000
000000000000000000000--H----H--000000000000--C--00
000000000000000000000----------000000000000-----00
00000000000000000000000######0000000000000000#0000
0----0----------------0######0---0-------0-------0
0---------------------0######0---0-M-0---0-------0
0----0----------------0------0---0---0---0---G---0
0----0000000000000===00------0---0---0-M-0-------0
0----0--c-------------0------0-------0-----------0
0----0----------M-----0------0---00000000000000000
0----0--B---M---------0------0----M----0---------0
0----0----------M-----0------0---M-M-------------0
0----0--c-------------0------0----M----0---------0
00--0000000000000000000------0000000000000000----0
0----0----@@@@@@@@@@--0------0--T---T---T---T----0
0-MM-0--C-##########--------------------------M--0
0----0----@@@@@@@@@@--0------0--T---T---T---T----0
00--000000000000000000000--00000000000000000000000
0----0------M-----------0----@@@@@@@@@@@@@@@-----0
0----0-------------C----0----@@@@@@@@@@@@@@@--M--0
0----=------M-----------0----###############-----0
0----0-------------C----0----@@@@@@@@@@@@@@@--M--0
0----0------M-----------0----@@@@@@@@@@@@@@@-----0
00--00000000000000000000000000000000000000000---00
0----00-------0----0---------0-----------0-------0
0T--T00--T0---0----0----S----0--M-----M--0-------0
0----00---0T--0----0---------0-----0-----0-------0
0T--T0T---0---0----0---------0-----0-----0-------0
0---------0--T0----0---------0--M--0--M--000-M-000
0-----T---0------------------------0-------------0
00000000000000000000000000000000000000000000000000

__________________________________________________
_  KEY
_
_ 0 = Wall
_
_ M = MOB
_
_ T = Trap (Thinking just something that shoots out projectiles when someone is near / damages you if you touch it but idk got no idea)
_
_ @ = Unpassible Ground
_
_ # = Unpassible untill X is Achived (ATM buttons / levers are my idea)
_
_ C = Chest
_
_ G = General (Sort of miny Boss)
_
_ =(=) Locked door (Sorry that was a bad choice for a tile  haha)
_
_ B = Button (The X i was discussing up there /\/\)
_
_ S = Player Start
_
_ H = Health pack (or something idk, getting ambitious)
_
_ Q = Mob Spawning point (Mob's spawn at intervals depending if the mobs that spawned before them are still alive or not)
_
_ ? = BOSS
__________________________________________________

